11111111111111111111111111111111111111111111111111111111
11111111111111111111111111111111111111111111111111111111
11111111111111111111111111111111111111111111111111111111
11111111111111111111111111111111111111111111111111111111
11111111111111111111111111111111111111111111111111111111
11111111111111111111111111111111111111111111111111111111
11111111111111111111111111111111111111111111111111111111
11111111111111111111111111111111111111111111111111111111
11111111111111111000000111111111111100000001111111111111
11110011100000100000000100000000000100000000011111111111
11110000000000100000000100000000000100000000010000000001
11110000000000100000000100000000000110001111110000000001
11110000000000111111000100000000000000000000000000000001
11110000000000000000000000000000000000000000000000000001
11111100000000000000000000000000000000000000000000000001
11111100000000000000000000011110000000000000000000000111
11111100000000000000000000000000000000000000000000000111
1111110000000000T000000000000000000000000000000000000111
11110000000000000000000000000000000000000000000000000111
11110000000000000000000000000000000000000000000000000111
11110000000000000000000000000000000000000000000000000111
11110000000000000000000000000000000000000000000000000111
11110000000000000000000000000011100000000000000000000111
11110000000000000000000000000111110000000000000000000111
11110000000000000000000000011111111000000000000000000111
11111100000000000000000000111111111000000000000000001111
11111110000000000000000000111111111100000000000000000111
11111101000000000000000000111111111100000000000000000111
11111000000000000000000000111111111000000000000000000111
11110000000000000000000000001111111000000000000000000111
11110000000000000000000000000111111000000000000000000111
11110000000000000000000000000011111000000000000000000111
11110000000000000000000000001111111000000000000000001111
11110000000000000000000000001101111000000000000000001111
11111000000000000000000000000000000000000000000000001111
11111000000000000000000000000000000000000000000000001111
11111000000000000000000000000000000000000000000000001111
11111000000000000000000000011100111000000000000000001111
11111000000000000000000000001000001111111000000000011111
11111000000000000000000000001000000000001000000000011111
11111110000000000000000000001000000000001001111111111111
11111110000001111111111111111111111110001001111111111111
11111111111111111111111111111111111111111111111111111111
11111111111111111111111111111111111111111111111111111111
11111111111111111111111111111111111111111111111111111111
